%%%%%%%%%%%%%%%%%%%%%%%%%%%%%%%%%%%%%%%%%%%%%%
%.. %%. %%%%%%%%%%% G ...%%%%%%%%%%%%... ... %
% G P ...%%%%%%%%%%  % %.. %%%%%%%%%%.   ....%
%.....%  %%%%%%%%%% .%.%%..%%%%%%%%%%..G.  ..%
%... .%..%%%%%%%%%%... %.  %%%%%%%%%%..... %%%
%.. . %%.  ..  .  ....... ... ... . .  .....G%
%.  G . .%%%%%%%%%%..G . . %%%%%%%%%%.%%. .%.%
%  %.....%%%%%%%%%%%.  .%  %%%%%%%%%% .. .%..%
%  ...% .%%%%%%%%%%  .....%%%%%%%%%%% .....  %
%%%%%%%%%%%%%%%%%%%%%%%%%%%%%%%%%%%%%%%%%%%%%%
