%%%%%%%%%%
%..%% . %%
%. . . %.%
%%P..%.%.%%%%%%%%%%%%%%%%%%%%%%%%%%%%%%%%%%%%%%%%
%..%... . 
%.. . ..% 
% G G.%.  
%.. .   .%%%%%%%%%%%%%%%%%%%%%%%%%%%%%%%%%%%%%%%%
% %.%...%%
%%%%%%%%%%
