%%%%%%%%%%%%%%%%%%%%%%%%%%%%
%. ..G  .%%%%%%%%%%% % ..  %
%.  ...% %%%%%%%%%%%...% .%%
%....  . %%%%%%%%%% %..%. %%
%.%.%%%..      ..  ...%... %
%.... .%%. ... ... .% .....%
%. .% ..P . .. .  ....  ...%
% . .%% .%%%%%%%%%%%%. ....%
%.... .%.%%%%%%%%%% .%.G...%
%%%%%%%%%%%%%%%%%%%%%%%%%%%%
