%%%%%%%%%%%%%%%%%%%%%%%%%%%%%%%%%%%%%%%%%%%%%%
%.. %%. %%%%%%%%%%%   ...%%%%%%%%%%%%... ... %
% G P ...%%%%%%%%%%  % %.. %%%%%%%%%%.   ....%
%.....%  %%%%%%%%%% .%.%%..%%%%%%%%%%.. .  ..%
%... .%.. .     ...... %.    . . ..  ..... %%%
%.. . %%.  ..  .  ....... ... ... . .  .....G%
%.    . ..  ..   . ..G . .  .. .. .. .%%. .%.%
%  %.....%%%%%%%%%%%.  .%  %%%%%%%%%% .. .%..%
%  ...% .%%%%%%%%%%  .....%%%%%%%%%%% .....  %
%%%%%%%%%%%%%%%%%%%%%%%%%%%%%%%%%%%%%%%%%%%%%%
