%%%%%%%%%%%%%%%%%%%%%%%%%%%%%%
%% ... %..% . ..    ..%.%.   %
%...... %..%. %.%..   ... ...%
%% .% .%..  %..%% %.... .%  %%
%.%   ....   %.. % % .%. .. .%
%. .%................%.%..  .%
%.%%%.. %%.. .  . % %.  %. ..%
%. % %  %%.%  P.   % ..% ...%%
% .%.% ...   % .%%..%%.%.....%
%. %  .. . .....% ...  .... .%
% ..%  ..%...%%.%.%. .   ... %
% .%.%..%% % %. ..%.%.... .. %
%..  %.%.....   .%  % .G%....%
%. ..... ..% .%% . .  .% . ..%
%..... %.% %.%%%G. %.. .. %%.%
%.  .%.... %%%  ... % % ....%%
%..%. . . .  .%%..% .% %  %  %
%.   . %% %%.%. %. . . . %...%
%..G.%%  ..   .. ..%. .%  . .%
%%%%%%%%%%%%%%%%%%%%%%%%%%%%%%
