%%%%%%%%%%
%.  % % .%
%%   .. .%
%.. %  G.%
%%.%  %..%
% .%.. %.%
% .P.. ..%
%. % G . %
%..%.... %
%%%%%%%%%%
